11111111111111111111
1s000000000000000011
10011111111111111011
10000001110011111011
10011000010000011011
11111100111100011011
10000000001000111011
10111111111111111011
10111000000000000011
10111011111110011111
10000011111110000001
11111111111110010111
10000000000000010111
11011111111111110111
11011111000001000111
11011111010111011111
11000000010000011111
11111111110011111111
111111111100000000e1
11111111111111111111